20 x 20
********************
*  F*        *   * *
* *** ****** * *   *
*   * *      * *****
*** * ********     *
* * *          *** *
* * ********** *S* *
* *      *   * * * *
* ****** * * * * * *
*      * * * * *   *
****** * * * * *****
*    * * * * * *   *
* ** * * * * * * * *
* **** * * *   * * *
* *      * *** *** *
* * ******   *     *
* *          ***** *
* **************** *
*                  *
********************
